10 10
1, 1, 1, 1, 1, 1, 1, 1, 1, 1, 
1, 1, 0, 0, 0, 0, 0, 1, 1, 1, 
1, 0, 2, 0, 0, 0, 0, 1, 1, 1, 
1, 0, 2, 2, 0, 0, 1, 1, 1, 1, 
1, 0, 0, 2, 0, 0, 1, 1, 1, 1, 
1, 0, 0, 2, 3, 0, 1, 1, 1, 1, 
1, 0, 0, 2, 0, 1, 1, 1, 1, 1, 
1, 1, 0, 0, 0, 1, 1, 1, 1, 1, 
1, 1, 1, 0, 0, 1, 1, 1, 1, 1, 
1, 1, 1, 1, 1, 1, 1, 1, 1, 1, 
6 1, 5 1, 4 1, 3 1, 2 1, 6 2, 