7 11
1, 1, 1, 1, 1, 1, 1, 
1, 0, 2, 0, 0, 0, 1, 
1, 0, 2, 0, 0, 0, 1, 
1, 0, 2, 0, 0, 0, 1, 
1, 0, 2, 2, 2, 0, 1, 
1, 0, 0, 0, 2, 0, 1, 
1, 1, 0, 0, 2, 0, 1, 
0, 1, 1, 0, 2, 0, 1, 
0, 0, 1, 0, 2, 0, 1, 
0, 0, 1, 1, 0, 3, 1, 
0, 0, 0, 1, 1, 1, 1, 
3 1, 2 2, 2 3, 2 4, 3 4, 4 4, 4 5, 4 6, 4 7, 4 8, 