16 13
0, 0, 0, 0, 0, 0, 0, 1, 1, 1, 1, 1, 0, 0, 0, 0, 
0, 0, 0, 0, 0, 1, 1, 1, 0, 0, 0, 1, 0, 0, 0, 0, 
1, 1, 1, 1, 0, 1, 0, 0, 2, 2, 0, 1, 1, 1, 1, 0, 
1, 0, 0, 1, 1, 1, 0, 0, 2, 0, 0, 1, 0, 0, 1, 0, 
1, 0, 0, 0, 0, 1, 1, 1, 2, 2, 0, 0, 2, 0, 1, 0, 
1, 0, 2, 1, 0, 0, 3, 0, 0, 1, 1, 0, 1, 0, 1, 0, 
1, 1, 0, 1, 1, 1, 1, 1, 0, 1, 0, 0, 1, 0, 1, 1, 
0, 1, 0, 0, 0, 0, 1, 1, 0, 1, 0, 0, 1, 0, 0, 1, 
0, 1, 1, 0, 0, 2, 0, 1, 0, 1, 0, 0, 0, 0, 0, 1, 
1, 0, 1, 1, 0, 2, 0, 1, 0, 0, 0, 0, 1, 1, 1, 1, 
0, 1, 0, 1, 1, 0, 0, 0, 0, 1, 0, 0, 1, 0, 0, 0, 
0, 0, 1, 0, 1, 1, 1, 1, 0, 0, 0, 1, 1, 0, 0, 0, 
0, 0, 0, 1, 0, 0, 0, 1, 1, 1, 1, 1, 0, 0, 0, 0, 
2 5, 10 9, 11 9, 11 8, 10 8, 10 7, 11 7, 11 6, 10 6, 