9 7
0, 1, 1, 1, 1, 1, 1, 1, 0, 
1, 1, 0, 0, 0, 0, 0, 1, 1, 
1, 0, 0, 0, 0, 2, 0, 3, 1, 
1, 0, 2, 2, 2, 2, 0, 0, 1, 
1, 0, 2, 0, 0, 2, 0, 0, 1, 
1, 0, 2, 0, 0, 2, 0, 0, 1, 
1, 1, 1, 1, 1, 1, 1, 1, 1, 
3 2, 3 3, 3 4, 3 5, 4 4, 4 5, 6 3, 6 4, 6 5